TTTTTTTTTTTTTTTTTTTTTTTTTTTTTTTTTTTTTTTTTTTTTTTTTTTTTTTTTTTTTTT
T000000000000MMM0000000000000000000000000000000000000000000000T
T000000000000000000000000M0000000000000000000000000M0000000000T
T00000000000000000000000000000000000000000000M0000000000000000T
T0000000000000000000000000000000000M00000000000000000000000000T
T000010000T000000000000000000000000000000000000000M00000000000T
T000000000T000000000000MM0000000000000000M000000000000000MM000T
T000000000T000000000000000000000000000M00000000000000000000000T
T000000000T00000000000000000000M00000000000000000M000M00000000T
T000000000T000000000000000000000000000000000000000000000000000T
T0000TTTTTT00000000000000000000000000000000000M00000000M000000T
T000000000000000000000000000M000000000000000000000000000000000T
T0000000000000000000000000000000000000000000000000000000000000T
T00000M0000000000000000000000000000000000000000000000000000000T
T0M0000000000000M000000000000000000000000000M00000000000000000T
T00000000000000000000000TTTTTTTTTTTTTTT000000000MM0000000000M0T
T00000000000000000000000T0000000000000T0000000000000000M000000T
T00000000000000000000000T0000000000000T00000000000000000000000T
T0000M000M00000000000000T0000000000000T000000000000M0000000000T
T00000000000000000MM0000T0000000000000T000000M000000M000000000T
T00000000000000000000000T000000M000000T00000000000000000000000T
T00000000000000000000000T0000000000000T00000000000000000000000T
T000000M0000000M00000000T0000000000000T0000000M000000000000000T
T00000000000000000000000T0000000000000T0000000000000000M000000T
T0000M000000000000000000T0000000000000T00000000000000000000000T
T00M00000000000000000000TTTTTT000TTTTTT00000000000000000000000T
T0000000000000000000000000M0000000000000000000000000000000M000T
T0000000000000M00000000000000000000M00000000000000000000000000T
T00000000000000000000000000M0000000000000000000M00000000000000T
T0000000M00000000M00M000000000000000000000000MMM00000000000000T
T000000000000000000000000000000000000M0000M0000000000M00000000T
T0000000000000000000000000000000000000000000000000000000000000T
T00000000000000M0000000000000000000000000000000000000000000000T
T000M00000000000000000000M00000M000000000000M00000000000000000T
T0000000000000000000000000000000000000000000000000000000000000T
T000000000000M0000000000000000000000M000000000000000TTTTTT0000T
T000000000000000000000000000000000000M0000000000000MT000000000T
T000000M000000000M0000000000000000000000000000000000T000000000T
T0000000000000000000000000MM000000000000000000000000T000000000T
T000000000000000000000000000000000000000000000000000T000000000T
T0000M0000000000000000000000000000000000000000000000T000020000T
T000000000000M00000000000000000000000000M000000000000000000000T
T0000000000000000000000000000000000000000000000000000000000000T
T00000000000000000000M0000000000000000000000000000000000000000T
T0000000000000000000000000000000000000000000000M00000000000000T
TTTTTTTTTTTTTTTTTTTTTTTTTTTTTTTTTTTTTTTTTTTTTTTTTTTTTTTTTTTTTTT
